NO ./textures/bricks.xpm
SO ./textures/dirt.xpm
WE ./textures/gold1.xpm
EA ./textures/stone.xpm
F 32,223,152
C 255,0,0


111111111111111111111          
10000011000001100001     
10100N0100100101111
1000010010100111001001
10000100001        00100101111
1000010000100   100101111
1000000000100100001111
1111111111111111111111

