NO FERETGE
SO GTRGTR
EA FERGTRGR
WE FREFREFEFE
F REGTEGREG
C FRGTRGRT


11111111111
10000000001
1000N100001
10000100101
11111111111